# Format: "TILE_ID Enum Val":"Position":"Rotation":"Scale"
GridLength: 3.5
GridHeight: 3.5
Tiles: 
141:0,0,0:1,0,0:1,1,1
141:14,0,0:1,0,0:1,1,1
141:21,0,0:1,0,0:1,1,1
141:28,0,0:1,0,0:1,1,1
141:35,0,0:1,0,0:1,1,1
141:42,0,0:1,0,0:1,1,1
141:49,0,0:1,0,0:1,1,1
141:56,0,0:1,0,0:1,1,1
141:63,0,0:1,0,0:1,1,1
141:70,0,0:1,0,0:1,1,1
141:77,0,0:1,0,0:1,1,1
141:84,0,0:1,0,0:1,1,1
141:91,0,0:1,0,0:1,1,1
141:105,-7,0:1,0,0:1,1,1
141:119,0,0:1,0,0:1,1,1
141:126,0,0:1,0,0:1,1,1
141:133,0,0:1,0,0:1,1,1
141:140,0,0:1,0,0:1,1,1
141:147,0,0:1,0,0:1,1,1
141:154,0,0:1,0,0:1,1,1
141:161,0,0:1,0,0:1,1,1
141:168,0,0:1,0,0:1,1,1
141:175,0,0:1,0,0:1,1,1
141:182,0,0:1,0,0:1,1,1
141:189,0,0:1,0,0:1,1,1
141:196,0,0:1,0,0:1,1,1
141:203,0,0:1,0,0:1,1,1
141:210,0,0:1,0,0:1,1,1
141:217,0,0:1,0,0:1,1,1
141:224,0,0:1,0,0:1,1,1
141:231,0,0:1,0,0:1,1,1
141:238,0,0:1,0,0:1,1,1
141:245,0,0:1,0,0:1,1,1
142:35,7,0:1,0,0:1,1,1
142:56,35,0:1,0,0:1,1,1
142:0,7,0:1,0,0:1,1,1
142:7,7,0:1,0,0:1,1,1
142:14,7,0:1,0,0:1,1,1
142:21,7,0:1,0,0:1,1,1
142:28,7,0:1,0,0:1,1,1
142:42,7,0:1,0,0:1,1,1
142:49,7,0:1,0,0:1,1,1
142:56,7,0:1,0,0:1,1,1
142:63,7,0:1,0,0:1,1,1
142:70,7,0:1,0,0:1,1,1
142:77,7,0:1,0,0:1,1,1
142:252,140,0:1,0,0:1,1,1
142:91,7,0:1,0,0:1,1,1
142:98,7,0:1,0,0:1,1,1
142:105,7,0:1,0,0:1,1,1
142:112,7,0:1,0,0:1,1,1
142:119,7,0:1,0,0:1,1,1
142:126,7,0:1,0,0:1,1,1
142:133,7,0:1,0,0:1,1,1
142:140,7,0:1,0,0:1,1,1
142:147,7,0:1,0,0:1,1,1
142:154,7,0:1,0,0:1,1,1
142:161,7,0:1,0,0:1,1,1
142:168,7,0:1,0,0:1,1,1
142:175,7,0:1,0,0:1,1,1
142:182,7,0:1,0,0:1,1,1
142:189,7,0:1,0,0:1,1,1
142:196,7,0:1,0,0:1,1,1
142:203,7,0:1,0,0:1,1,1
142:210,7,0:1,0,0:1,1,1
142:217,7,0:1,0,0:1,1,1
142:224,7,0:1,0,0:1,1,1
142:231,7,0:1,0,0:1,1,1
142:238,7,0:1,0,0:1,1,1
142:245,7,0:1,0,0:1,1,1
142:252,7,0:1,0,0:1,1,1
141:98,-7,0:1,0,0:1,1,1
141:98,0,0:1,0,0:1,1,1
141:98,42,0:1,0,0:1,1,1
141:105,49,0:1,0,0:1,1,1
141:112,49,0:1,0,0:1,1,1
141:112,56,0:1,0,0:1,1,1
141:119,56,0:1,0,0:1,1,1
141:133,56,0:1,0,0:1,1,1
141:140,49,0:1,0,0:1,1,1
141:147,49,0:1,0,0:1,1,1
141:147,42,0:1,0,0:1,1,1
141:154,42,0:1,0,0:1,1,1
141:119,49,0:1,0,0:1,1,1
141:126,49,0:1,0,0:1,1,1
141:133,49,0:1,0,0:1,1,1
141:105,42,0:1,0,0:1,1,1
141:140,42,0:1,0,0:1,1,1
141:112,42,0:1,0,0:1,1,1
141:91,35,0:1,0,0:1,1,1
141:105,35,0:1,0,0:1,1,1
141:147,35,0:1,0,0:1,1,1
141:154,35,0:1,0,0:1,1,1
141:161,35,0:1,0,0:1,1,1
143:28,56,0:1,0,0:1,1,1
142:245,56,0:1,0,0:1,1,1
142:238,56,0:1,0,0:1,1,1
142:231,56,0:1,0,0:1,1,1
142:252,56,0:1,0,0:1,1,1
142:252,56,0:1,0,0:1,1,1
141:105,0,0:1,0,0:1,1,1
141:112,0,0:1,0,0:1,1,1
142:84,7,0:1,0,0:1,1,1
142:0,140,0:1,0,0:1,1,1
142:7,140,0:1,0,0:1,1,1
142:14,140,0:1,0,0:1,1,1
142:21,140,0:1,0,0:1,1,1
142:28,140,0:1,0,0:1,1,1
142:35,140,0:1,0,0:1,1,1
142:42,140,0:1,0,0:1,1,1
142:49,140,0:1,0,0:1,1,1
142:56,140,0:1,0,0:1,1,1
142:63,140,0:1,0,0:1,1,1
142:70,140,0:1,0,0:1,1,1
142:77,140,0:1,0,0:1,1,1
142:84,140,0:1,0,0:1,1,1
142:91,140,0:1,0,0:1,1,1
142:98,140,0:1,0,0:1,1,1
142:105,140,0:1,0,0:1,1,1
142:112,140,0:1,0,0:1,1,1
142:119,140,0:1,0,0:1,1,1
142:126,140,0:1,0,0:1,1,1
142:133,140,0:1,0,0:1,1,1
142:140,140,0:1,0,0:1,1,1
142:147,140,0:1,0,0:1,1,1
142:154,140,0:1,0,0:1,1,1
142:161,140,0:1,0,0:1,1,1
142:168,140,0:1,0,0:1,1,1
142:175,140,0:1,0,0:1,1,1
142:182,140,0:1,0,0:1,1,1
142:189,140,0:1,0,0:1,1,1
142:196,140,0:1,0,0:1,1,1
142:203,140,0:1,0,0:1,1,1
142:210,140,0:1,0,0:1,1,1
142:217,140,0:1,0,0:1,1,1
142:224,140,0:1,0,0:1,1,1
142:231,140,0:1,0,0:1,1,1
142:252,140,0:1,0,0:1,1,1
142:245,140,0:1,0,0:1,1,1
142:252,140,0:1,0,0:1,1,1
142:238,140,0:1,0,0:1,1,1
141:140,56,0:1,0,0:1,1,1
141:77,98,0:1,0,0:1,1,1
141:63,91,0:1,0,0:1,1,1
141:56,84,0:1,0,0:1,1,1
141:56,91,0:1,0,0:1,1,1
141:49,84,0:1,0,0:1,1,1
141:70,98,0:1,0,0:1,1,1
141:70,91,0:1,0,0:1,1,1
141:84,98,0:1,0,0:1,1,1
141:84,91,0:1,0,0:1,1,1
141:91,91,0:1,0,0:1,1,1
141:98,91,0:1,0,0:1,1,1
141:105,91,0:1,0,0:1,1,1
141:105,84,0:1,0,0:1,1,1
141:112,84,0:1,0,0:1,1,1
141:140,84,0:1,0,0:1,1,1
141:161,98,0:1,0,0:1,1,1
141:168,98,0:1,0,0:1,1,1
141:175,98,0:1,0,0:1,1,1
141:182,98,0:1,0,0:1,1,1
141:182,91,0:1,0,0:1,1,1
141:189,91,0:1,0,0:1,1,1
141:196,91,0:1,0,0:1,1,1
141:196,84,0:1,0,0:1,1,1
141:203,84,0:1,0,0:1,1,1
141:70,98,0:1,0,0:1,1,1
142:182,63,0:1,0,0:1,1,1
142:77,63,0:1,0,0:1,1,1
142:70,63,0:1,0,0:1,1,1
143:63,35,0:1,0,0:1,1,1
143:84,63,0:1,0,0:1,1,1
143:63,63,0:-1,-8.74228e-08,0:1,1,1
141:7,84,0:1,0,0:1,1,1
141:245,84,0:1,0,0:1,1,1
141:252,91,0:1,0,0:1,1,1
142:175,63,0:1,0,0:1,1,1
143:168,63,0:-1,-8.74228e-08,0:1,1,1
143:189,63,0:1,0,0:1,1,1
141:147,91,0:1,0,0:1,1,1
141:147,84,0:1,0,0:1,1,1
141:154,91,0:1,0,0:1,1,1
141:161,91,0:1,0,0:1,1,1
141:210,84,0:1,0,0:1,1,1
141:224,98,0:1,0,0:1,1,1
141:28,98,0:1,0,0:1,1,1
141:42,84,0:1,0,0:1,1,1
141:98,35,0:1,0,0:1,1,1
141:98,28,0:1,0,0:1,1,1
141:91,28,0:1,0,0:1,1,1
141:84,28,0:1,0,0:1,1,1
141:154,28,0:1,0,0:1,1,1
141:168,28,0:1,0,0:1,1,1
141:161,28,0:1,0,0:1,1,1
143:14,21,0:1,0,0:1,1,1
142:7,21,0:1,0,0:1,1,1
142:0,21,0:1,0,0:1,1,1
142:-7,56,0:1,0,0:1,1,1
142:49,35,0:1,0,0:1,1,1
141:14,77,0:1,0,0:1,1,1
141:7,77,0:1,0,0:1,1,1
141:0,84,0:1,0,0:1,1,1
141:0,91,0:1,0,0:1,1,1
141:252,84,0:1,0,0:1,1,1
141:245,77,0:1,0,0:1,1,1
141:238,77,0:1,0,0:1,1,1
143:35,35,0:-1,-8.74228e-08,0:1,1,1
143:238,21,0:-1,-8.74228e-08,0:1,1,1
142:245,21,0:1,0,0:1,1,1
142:252,21,0:1,0,0:1,1,1
143:217,35,0:1,0,0:1,1,1
143:189,35,0:-1,8.74228e-08,0:1,1,1
143:224,56,0:-1,-8.74228e-08,0:1,1,1
142:196,35,0:1,0,0:1,1,1
142:203,35,0:1,0,0:1,1,1
142:210,35,0:1,0,0:1,1,1
142:42,35,0:1,0,0:1,1,1
142:21,56,0:1,0,0:1,1,1
142:14,56,0:1,0,0:1,1,1
142:7,56,0:1,0,0:1,1,1
142:0,56,0:1,0,0:1,1,1
142:-7,56,0:1,0,0:1,1,1
141:126,56,0:1,0,0:1,1,1
6:126,14,0:1,0,0:1,1,1
145:126,33.232,0:1,0,0:3.98969,3.98969,3.98969
142:0,119,0:1,0,0:1,1,1
142:7,119,0:1,0,0:1,1,1
143:133,112,0:1,0,0:1,1,1
143:14,119,0:1,0,0:1,1,1
142:126,112,0:1,0,0:1,1,1
142:252,119,0:1,0,0:1,1,1
142:245,119,0:1,0,0:1,1,1
143:119,112,0:-1,-8.74228e-08,0:1,1,1
143:238,119,0:-1,-8.74228e-08,0:1,1,1
134:203,35,0:1,0,0:1,1,1
134:70,70,0:1,0,0:1,1,1:DECORATIVE
134:14,63,0:1,0,0:1,1,1:DECORATIVE
134:91,42,0:1,0,0:1,1,1:DECORATIVE
134:56,14,0:1,0,0:1,1,1:DECORATIVE
134:7,91,0:1,0,0:1,1,1:DECORATIVE
134:126,119,0:1,0,0:1,1,1:DECORATIVE
134:105,98,0:1,0,0:1,1,1:DECORATIVE
134:175,70,0:1,0,0:1,1,1:DECORATIVE
134:196,98,0:1,0,0:1,1,1:DECORATIVE
134:133,63,0:1,0,0:1,1,1:DECORATIVE
134:196,42,0:1,0,0:1,1,1:DECORATIVE
134:168,35,0:1,0,0:1,1,1:DECORATIVE
134:238,84,0:1,0,0:1,1,1:DECORATIVE
134:245,63,0:1,0,0:1,1,1:DECORATIVE
135:84,70,0:1,0,0:1,1,1:DECORATIVE
135:14,126,0:1,0,0:1,1,1:DECORATIVE
135:98,49,0:1,0,0:1,1,1:DECORATIVE
135:70,105,0:1,0,0:1,1,1:DECORATIVE
135:168,105,0:1,0,0:1,1,1:DECORATIVE
135:252,126,0:1,0,0:1,1,1:DECORATIVE
135:245,91,0:1,0,0:1,1,1:DECORATIVE
135:161,42,0:1,0,0:1,1,1:DECORATIVE
135:28,105,0:1,0,0:1,1,1:DECORATIVE
135:42,91,0:1,0,0:1,1,1:DECORATIVE
134:49,42,0:1,0,0:1,1,1:DECORATIVE
134:35,42,0:1,0,0:1,1,1:DECORATIVE
141:252,0,0:1,0,0:1,1,1
141:259,0,0:1,0,0:1,1,1
141:259,7,0:1,0,0:1,1,1
141:259,14,0:1,0,0:1,1,1
141:259,21,0:1,0,0:1,1,1
141:259,28,0:1,0,0:1,1,1
141:252,63,0:1,0,0:1,1,1
141:259,49,0:1,0,0:1,1,1
141:259,35,0:1,0,0:1,1,1
141:259,42,0:1,0,0:1,1,1
141:259,56,0:1,0,0:1,1,1
141:259,63,0:1,0,0:1,1,1
141:259,70,0:1,0,0:1,1,1
141:259,77,0:1,0,0:1,1,1
141:259,84,0:1,0,0:1,1,1
141:259,91,0:1,0,0:1,1,1
141:259,98,0:1,0,0:1,1,1
141:259,105,0:1,0,0:1,1,1
141:259,140,0:1,0,0:1,1,1
141:259,133,0:1,0,0:1,1,1
141:259,126,0:1,0,0:1,1,1
141:259,119,0:1,0,0:1,1,1
141:259,112,0:1,0,0:1,1,1
141:7,0,0:1,0,0:1,1,1
141:0,14,0:1,0,0:1,1,1
141:0,28,0:1,0,0:1,1,1
141:0,35,0:1,0,0:1,1,1
141:0,42,0:1,0,0:1,1,1
141:0,49,0:1,0,0:1,1,1
141:0,63,0:1,0,0:1,1,1
141:0,70,0:1,0,0:1,1,1
141:0,77,0:1,0,0:1,1,1
141:0,105,0:1,0,0:1,1,1
141:0,98,0:1,0,0:1,1,1
141:0,112,0:1,0,0:1,1,1
141:0,126,0:1,0,0:1,1,1
141:0,133,0:1,0,0:1,1,1
135:231,14,0:1,0,0:1,1,1:DECORATIVE
135:252,28,0:1,0,0:1,1,1:DECORATIVE
135:7,28,0:1,0,0:1,1,1:DECORATIVE
134:203,14,0:1,0,0:1,1,1
182:126,63,0:1,0,0:1,1,1
