# Format: "TILE_ID Enum Val":"Position":"Rotation":"Scale"
GridLength: 3.5
GridHeight: 3.5
Tiles: 
119:0,28,0:1,0,0:1,1,1
114:7,28,0:1,0,0:1,1,1
114:14,28,0:1,0,0:1,1,1
114:21,28,0:1,0,0:1,1,1
114:35,28,0:1,0,0:1,1,1
114:42,28,0:1,0,0:1,1,1
114:49,28,0:1,0,0:1,1,1
114:28,28,0:1,0,0:1,1,1
114:56,28,0:1,0,0:1,1,1
114:63,28,0:1,0,0:1,1,1
114:70,28,0:1,0,0:1,1,1
114:77,28,0:1,0,0:1,1,1
114:84,28,0:1,0,0:1,1,1
114:91,28,0:1,0,0:1,1,1
114:98,28,0:1,0,0:1,1,1
114:105,28,0:1,0,0:1,1,1
114:112,28,0:1,0,0:1,1,1
114:119,28,0:1,0,0:1,1,1
120:126,28,0:1,0,0:1,1,1
6:42,189,0:1,0,0:1,1,1
