# Format: "TILE_ID Enum Val":"Position":"Rotation":"Scale"
GridLength: 3.5
GridHeight: 3.5
Tiles: 
119:0,28,0:1,0,0:1,1,1
114:7,28,0:1,0,0:1,1,1
114:14,28,0:1,0,0:1,1,1
114:21,28,0:1,0,0:1,1,1
114:35,28,0:1,0,0:1,1,1
114:42,28,0:1,0,0:1,1,1
114:49,28,0:1,0,0:1,1,1
114:28,28,0:1,0,0:1,1,1
6:42,189,0:1,0,0:1,1,1
113:91,77,0:1,0,0:1,1,1
114:126,28,0:1,0,0:1,1,1
114:133,28,0:1,0,0:1,1,1
114:140,28,0:1,0,0:1,1,1
114:147,28,0:1,0,0:1,1,1
114:154,28,0:1,0,0:1,1,1
114:161,28,0:1,0,0:1,1,1
114:56,28,0:1,0,0:1,1,1
